28
13
############################
############################
##........................##
##........................##
##........................##
##........................##
@..........................@
##........................##
##........................##
##........................##
##........................##
#############..#############
#############@@#############