28
13
#############@@#############
#############..#############
##........................##
##........................##
##........................##
##........................##
@..........................@
##........................##
##........................##
##........................##
##........................##
#############..#############
#############@@#############