28
13
#############@@#############
#############..#############
##........................##
##........................##
##........................##
##........................##
##.........................@
##........................##
##........................##
##........................##
##........................##
#############..#############
#############@@#############