28
13
#############@@#############
#############..#############
##........................##
##........................##
##........................##
##........................##
@..........................@
##........................##
##........................##
##........................##
##........................##
############################
############################