28
13
#############@##############
#..........................#
#..........................#
#..........................#
#..........................#
#..........................#
@..........................@
#..........................#
#..........................#
#..........................#
#..........................#
#..........................#
#############@##############

